1111111
10C00E1
1C00001
1001001
101P101
1111111