1111111
10C00P1
1C00001
1001001
101E101
1111111