1111111
10000E1
1P00001
1001001
101C101
1111111