1111111
1000001
1P01001
100E001
101C101
1111111