1111111
101C101
100E001
1001001
1P00001
1111111