1111111111111111111111111111111111
10000000000000C00000C0000000000001
1C100100001000001010010000C0010101
1E10010C10101010001001000000010101
1C1P00000000C000000000000000000001
1111111111111111111111111111111111